processor: 處理器
process: 處理、過程
simply: 簡單地
state: 陳述、長期狀態、州
status: 狀態
figure: 圖、樣貌、範例、(= example)
equivalent: 等價的、(= same)
role: 角色
detect: 偵測
during: 在...期間
produce: 產生、製造
interpreter: 直譯器、轉譯者
common: 普通的、常見的
instead: 反而
appear: 出現、顯示
directly: 直接地
operate: 操作、運行
specify: 指定、特定
supplied: 提供、供應
usually: 通常
much: 很多
however: 然而
diagnose: 診斷
diagnostic: 診斷的
statement: 陳述、聲明、(通常比單一句子長)
combine: 結合
compilation: 編譯、彙總
interpretation: 解釋
shown: 顯示、(被動)
intermediate: 中間的
inter- : 中間、之間
internet: 網際網路
international: 國際的
interpreted: 直譯的
virtual: 虛擬的
visual: 視覺的
benefit: 利益、好處、(= advantage)、(= pros)
arrange: 安排、整理、佈置
perhaps: 也許、可能
across: 橫過、穿越
in order to: 為了
achieve: 達成、實現
immediate: 立即的、即時的
hybrid: 混合的
addition to: 除此之外
several: 幾個、數個、(= some)
require: 要求
divide: 拆分、分開
modules: 模組
separate: 分開的
task: 任務
collecting: 收集
entrust: 委託、信任
expand: 擴展
shorthand: 速記、簡寫
macro: 巨集、指令、大量
micro- : 微小的
modified: 修改的
fed: 餵給、餵養(過去式)
feed: 餵養、餵食、給
assembly: 組裝
easier: 更容易的
easy: 容易的
relocatable: 可重定位的
relocate: 重新定位
locate: 定位、放置
large: 大的
piece: 塊、片
actually: 實際上
resolve: 解決、(= solve)
external: 外部的
refer: 提及、參考
reference: 參考
exercises: 練習、運動
section: 部分、章節、(= part)
mission: 任務
advantage: 優勢
rather: 寧可、相當
perform: 執行、表現、(= do)
