up to this point: 到目前為止
treat: 對待
single: 單一的
semantically: 語義上、字面上
equivalent: 等價的
equal: 相等的
analysis: 分析
synthesis: 合成
analyze: 分析
synthesize: 合成
break: 拆開
constituent: 成分、組成
imposes: 施加、執行
grammatical: 語法的
representation: 表示、表徵 (= show)
either: 兩者之一
syntactically: 句法上的
ill: 不好的、壞的
semantically: 語法上
unsound: 不正確的、無效的
provide: 提供
informative: 提供資訊的
corrective: 糾正的、正確的
along: 沿著、隨著
desired: 理想的、想要的
front end: 前端
back end: 後端
examine: 檢查、審查 (= check)
detail: 細節
fed: 餵給
feed: 餵食、給
easier: 更容易的
may: 可能
might: 可能 (可能性較小)
examine: 檢查 (= check)
operate: 操作、運行
phase: 階段、時期 (ph = f) (= stage)
representation: 呈現方式
typical: 典型的
decomposition: 分解、分拆
practice: 實際上
several: 幾個、數個
grouped: 分組的
construct: 構造、建造
explicitly: 明確地
entire: 整個的
lexical: 詞彙的
syntax: 語法、句法
semantic: 語意的
independent: 獨立的
optimizer: 優化器
dependent: 依賴的
purpose: 目的 (= target)
perform: 執行 (= do)
otherwise: 否則
since: 自從、因為
scanning: 掃描
analysis: 分析
meaningful: 有意義的
lexeme: 詞素、詞根、詞位
subsequent: 隨後的、後續的
abstract: 抽象的
absolute: 絕對的
during: 在...期間
component: 組件、元件
entry: 進入
suppose: 認為、假設
assignment: 作業、指派
statement: 陳述、聲明
following: 以下的
multiply: 乘以
stand for: 代表
identify: 辨認
omit: 省略
such as: 例如
notational: 做記號的
convenience: 方便、便利
chosen: 選擇的 (choose - chose - chosen)
initial: 初始的
initialize: 最初的、前面的、簽名的、名字開頭的
blank: 空白
separate: 分開的
discarded: 丟棄的
multiplication: 乘法
respectively: 相對的
respect: 尊重
technically: 技術上
internal: 內部的
defer: 尊崇、推遲
discuss: 討論
phrase: 短語、片語
depict: 描述
interior: 內部的
indicate: 指出
consistent: 持續的
usual: 通常的
convention: 習俗、慣例
precedence: 優先權、優先
grammatical: 語法的
chapter: 章節
specify: 指定、特定
spec: 規格
discuss: 討論
algorithm: 演算法
efficient: 高效的
automatically: 自動地
certain: 特定的
directed: 指向的、導向的
consistency: 一致性
gather: 集結
either: 兩者之一
both: 兩者皆可
neither: 兩者皆不
during: 在...期間
important: 重要的
import: 匯入
operands: 操作數
require: 需要
specification: 規範
permit: 允許
conversion: 轉換
convert: 轉換
coercions: 控制、強制
arithmetic: 算術的
applied: 應用的
suppose: 假設
form: 形成、格式
extra: 額外的
explicitly: 明確地
a variety of: 多種的
commonly: 常見的
think of as: 視為
property: 屬性
consider: 考慮、視為
per: 每個
act: 表現
