complicated: 複雜的
essence: 本質
mathematically: 數學上
serve: 服務
excellent: 優秀的 (= good)
illustration: 插圖、舉證
capture: 捕捉
characteristic: 特徵
formulation: 公式化
grounded: 基於
solid: 堅固的
understanding: 理解
refine: 定義
empirically: 實證地、經驗上的
accept: 接受
conform: 符合
performed: 執行
influence: 影響
leverage: 槓桿
balancing: 平衡
generality: 一般性
against: 反對、對抗
simplicity: 簡單性
efficiency: 效率
recognize: 認識
nesting: 嵌套
parentheses: 括號
object: 目標
refers: 指
obvious: 明顯的
misnomer: 誤稱
guarantee: 保證
complex: 複雜的
yield: 產生、放棄、良率
opportunity: 機會
improve: 改善
massively: 大量地
parallel: 平行的
substantial: 大量的
suffer: 遭受
magnitude: 大小、數量、規模
prevalence: 流行
out of: 由於、出自於、源於、沒有、缺少
extensive: 廣泛的、延展性
rigorous: 嚴謹的
foundation: 基礎
desirable: 令人滿意的、可望的
matrices: 矩陣
linear: 線性的
necessary: 必要的
on the other hand: 另一方面
pure: 純粹的
insufficient: 不足的
sufficient: 足夠的
ability: 能力
formulate: 公式化
understand: 理解
behavior: 行為
thorough: 徹底的
experiment: 實驗
evaluation: 評估
intuition: 直覺
performance: 表現
kept: 保持
effort: 努力、效益
required: 需要的
manageable: 可管理的
overemphasize: 過度強調
emphasize: 強調
correctness: 正確性
trivial: 瑣碎的
difficult: 困難的
dare: 敢於
completely: 完全地
embedded: 嵌入的
application: 應用
mobile: 行動的
device: 裝置
wish: 希望
minimize: 最小化
consumption: 消耗
typically: 通常
conserve: 節省
usability: 可用性
rapid: 快速的
obscure: 模糊的
expose: 暴露
deters: 威脅、阻止
turning: 轉折
