basic: 基礎
terminology: 術語
terminal: 終端
terminate: 終止、終結
distinction: 區別、區分
assume: 假設、認為
reader: 讀者、閱讀器
familiar: 熟悉的、親切的
family: 家族、系列
least: 最少、至少
static: 靜態的、不變的
designing: 設計、設計過程
policy: 政策、規則
decide: 決定、決策
concentrate: 集中、專注
regin: 區域、範圍
determine: 確定、決定
overwise: 過度地、過分地
applies: 應用、適用
held: 握住、舉行
omitted: 被省略的、被忽略的
occurring: 發生
affect: 影響
element: 元素
denoted: 表示
instance: 實例
depending: 取決於
association: 聯繫
according to: 根據
fragment: 片段
reserved: 保留的
adjust: 調整
