-ized: 使...化
Macintosh: 麥金塔
a variety of: 各式各樣的、(= various)
ability: 能力
above: 以上、在...之上
absolute: 絕對的
abstract: 抽象的、摘要
abstraction: 抽象、抽象化
accept: 接受
acceptable: 合意的、可接受的
access: 訪問
accessed: 訪問
accesses: 訪問
accessible: 可訪問的
accompanied: 陪伴的
accord: 根據、符合
according to: 根據
according: 依照、根據
achieve: 實現、達成
acquire: 獲得
across: 橫過、穿越
act: 表現
activities: 活動
actual: 實際的、真實的
actually: 實際上、事實上
addition to: 除此之外
addition: 加法、加法運算
additionally: 除此之外
additive: 加法的、可加的
adequate: 足夠的
adjacent: 相鄰的
adjust: 調整
advance: 進步
advantage: 優勢
affect: 影響
against: 反對、對抗
aggregate: 聚合、總計
aid: 援助、幫助
alarms: 警報
alert: 警報、警告
algorithm: 演算法
alias: 別稱、別名
aliasing: 化名、別名
allocate: 分配
allocating: 分配
allocation: 分配、安排
almost: 幾乎
along: 沿著、隨著
alphabet: 字母系統、字母表
alter: (= change)、改變
alternate: 輪流、交替
alternative: 替代方案、可供選擇的、可選擇的、選擇的、替代的、另類的
alternatively: 交替地、或者
although: 雖然
ambiguity: 不明確、歧義、模糊
ambiguous: 模糊的、不明確的
among: 在...之間、在...之中
amount: 數量
analogous: 類似的、相似的
analogy: 類似、類比
analysis: 解析、分析
analyze: 分析
ancestor: 前輩、祖先
and can: 並且可以
and so on: 以此類推、等等
angle: 角度、角
annotate: 註解、註釋
annotated: 註解、註釋
apart: 分開、分離
apparently: 顯然地、明顯地
appear: 顯現、出現、顯示
appearance: 出現、外觀
appearing: 出現、顯示
append: 附加、附錄
appendix: 附加物、附錄
applicable: 適用於
application: 應用
applications: 應用
applied: 實用的、應用的
applies: 應用、適用
apply: 使用、應用、適用
approach: 途徑、方法
approaches: 途徑、方法
appropriate: 合適的、適當的
approximation: 近似、估計
arbitrarily: 任意地、隨意地
arbitrary: 任意的、隨意的、隨機的
architecture: 建築、建構、架構、工程
areas: 領域
arguably: 可以說
arithmetic: 數學的、算術的、計算、算術
arity: 元數、元運算元
arrange: 整理、佈置、安排
array: 排列、陣列、數組
arrow: 箭頭、指示
artifact: 人造
as ... as: 盡可能地
as a result: 因此、結果
as well as: 以及、同樣地
asks: 詢問、要求
aspect: 方面
assembly: 組裝
assigned: 指定的、分配的
assignment: 作業、指派
assist: 協助
associate: 聯繫、關聯、聯想
associated: 相關的、聯繫的、聯想的、關聯的
associating: 聯繫、聯想
association: 聯繫、聯合、協會
associativity: 結合性、聯繫性
assume: 假設、認為
assumption: 假設、前提
assure: 確保
at most: 最多
attach: 連接、附加
attaches: 連接、附加
attaching: 連接、附加
attempt: (= try)、嘗試
attribute: 特性、屬性、特質、特徵
automata: 自動機
automatically: (= auto)、自動地
availability: 可用性
available: 可獲得的、可用的
average: 平均
avoid: 避免、防止
back end: 後端
backward: 向後的
balance: 平衡
balancing: 平衡
basic: 基礎
become: 變成、成為
behave: 舉止、行為
behavior: 行為
belong: 歸屬、屬於
belonging: 歸屬、屬於
benefit: 好處、(= pros)、利益、(= advantage)
beside: 在旁邊、除...之外
better: 更好
between: 在...之間
beyond: 在...之外、超越
binding: 約束、綁定
blank: 空白、空格
bodies: 身體、物體
boldface: 粗體字、粗體
both: 兩者皆可
bound: 有界的
breach: 違反、破壞
break up: 拆分、分解
break: 拆開
brief: 簡短的
built: (build - built - built)、建造的
callee: 被呼叫者、被調用者
capabilities: 能力
capability: 能力、性能
capable: 有能力的、能幹的
capture: 捕捉
career: 職涯、職業
careful: 小心的、謹慎的
careless: 粗心的
carries: 承載、攜帶
carry out: 執行、實施
carry: 承載、攜帶
catastrophic: 災難性的
category: 類別
cause: 原因、導致
caused: 引起
certain: 某些、確定的、特定的
challenging: 挑戰的
chapter: 章節、篇章
character: 字符、特徵、角色、字元
characteristic: 特徵
child: 孩子、子
childhood: 幼年、童年
children: 孩子們、兒童
chosen: (choose - chose - chosen)、選擇的
circuit: 電路
circumstance: 情況
clarification: 闡明、澄清
clarify: 闡明、澄清
classification: 分類
classified: 分類的
clearly: 明確地
close: 接近的、關閉的
closely: 緊密地、密切地
closest: 最近的
closure: 封閉、關閉
coercions: 強制、控制
collecting: 收集
collection: 收集、集合、版本
combination: 組合
combine: 結合、合併
comma: 分隔符、逗號
commodity: 商品
common: 普通的、常見的
commonly: 普遍的、常見的
companies: 公司
compatibility: 兼容性
compilation: 編譯、彙總
compiling: 編譯
complementary: 互補的、補充的
complete: 完整的、完成、完全的
completely: 完全地
complex: 複雜的、綜合體
complicated: 複雜的
component: 元件、成分、組件
compromise: 危害、妥協
compute: 計算
computed: 估算、計算
concatenation: 連接、並列、串聯
concentrate: 集中、專注
concept: 概念
concepts: 概念
conclude: 總結
condition: 狀況、條件
conform: 符合
connected: 聯繫、連接
consequence: 結果、後果
consequently: 因此
conservative: 保守的
conserve: 節省
consider: 考慮、認為、視為
considered: 考慮、視為
consist: 由...組成、組成、包含
consistency: 一致性
consistent: 持續的
consisting: 組成的、組成、構成
consists: 由...組成、包含
constant: 不變的、常數
constituent: 成分、組成、構成要素
constraint: 約束、限制
construct: 構造、建造、建構
consume: 消耗
consumption: 消耗
contain: 容納、包含
containing: 包含
context-free: 無上下文的、無語境的
context: 語境、上下文
continuously to: 持續地、不斷地
contrast: 對照、對比
contribute: 促成、貢獻
convenience: 方便、便利
convenient: 方便的、便利的
conveniently: 便利地、方便地
convention: 慣例、習俗
conventional: 傳統的、常規的
converge: 匯聚
conversion: 轉換
convert: 轉換
copied: copy p.p.、抄襲的、複製的
correct: 正確的
corrective: 糾正的、正確的
correctly: 正確地
correctness: 正確性
correspond: 呼應、回應、回答、符合、對應
corresponding: 相應的、對應的
correspondingly: 相應地
cost: 成本
could: (can - could)、可以
cover: 涵蓋、覆蓋
creating: 創建、創造
critical: 關鍵的、(= important)
crucial: 關鍵的
curly braces: 大括號
curly: 捲毛的、捲曲的
currently: 目前、當前
dare: 敢於
dash: 虛線、破折號
dashed: 虛線的、破折號的
deal with: 應付、處理、應對
deal: 交易、處理
decade: 十年
decades: 幾十年
decide: 決策、決定
decided: 已決定的、決定的
deciding: 判斷、決定
decision: 決策、決定
declaration: 宣告、聲明
declarative: 陳述的、聲明的
decomposition: 分拆、分解
deduce: 推斷、推導
defer: 尊崇、推遲
define: 定義、確定
definition: 說明、定義、解釋
delimit: 界定、劃定
deliver: 傳遞
demand: 需求
denote: 指示、表示
denoted: 表示
depend on: 取決於、依賴於
dependencies: 依賴關係
dependent: 依賴的
depending: 取決於
depends: 依賴、取決於
depict: 描述
dereference: 解引用
dereferencing: 解引用
derivation: 衍生、派生
derive: 衍生、得出
derived: 衍生的、得出的
derives: 衍生、導出、得出
descendant: 子孫、後代
descendants: 子孫、後代
descent: 下降、世系
describe: 敘述、描述、形容
describing: 描述、形容
design: 設計
designation: 名稱、指定
designed: 設計的
designing: 設計過程、設計
desirable: 可取的、令人滿意的、理想的、可望的
desire: 可望、渴望、希望
desired: 想要的、期望的、理想的、所需的
destination: 目的地、終點
detail: 細節
detect: 偵測、檢測
detector: 偵測器
determination: 確定、決心
determine: 確定、決定
determined: 確定、決定
determining: 確定、決定
deters: 威脅、阻止
develop: 開發、發展
developed: 開發的
device: 裝置
devise: 設計、發明
diagnose: 診斷
diagnostic: 診斷的
differ: 差異、不同
different: 不同的、有差異的
differently: 有差別地、不同地
difficult: 艱難的、困難的
digit: 數字、數位
direct: 指揮、指導、直接的
directed: 導向的、指向的
direction: 方向
directly: 直接地、坦率地
discarded: 丟棄的
discipline: 學科、原則
discover: 探索、發現
discuss: 討論
discussed: 討論、商量
discussing: 商討、討論
discussion: 討論
distinct: 不同的、獨特的
distinction: 區別、區分、差別
distinguish: 區分、辨別
distinguishes: 區分、辨別
distinguishing: 區分、辨別
distribute: 分布
distributed memory: 分布式存儲
distributed: 分布式
distributing: 分發
diversity: 多樣性
divide: 拆分、分開
division: 除法運算、除法
domination: 支配
done: 做好的、完成的
draw: 畫、繪製
during: 在...時、在...期間、在...過程中
dynamic: 動態的
dynamically: 動態地
easier: 更容易的
easy: 容易的
economic: 經濟的
edge: 邊緣、邊界
effect: 效果、影響
effectively: 有效地、實際上
effectiveness: 有效性
efficiency: 效率
efficient: 高效的
effort: 努力、效益
either: 兩者之一
element: 成分、元素
elementary: 基本的、初級的
eliminate: 剔除
eliminating: (= delete)、消除
embed: 嵌入
embedded: 嵌入的、內嵌的
emphasis: 重點、強調
emphasize: 強調
empirically: 經驗上的、實證地
empty: 空的、空白的
encapsulation: 封裝、包裝
enclose: 封閉、封入、附上、包圍
enclosing: 圍繞、包含
encounter: 遇到
engineering: 工程學
enough: 足夠的、充分的
ensure: 保證、確保
entire: 整個的
entity: 存在、實體
entrust: 委託、信任
entry: 進入
environment: 環境、環境因素
equal: 相等的
equivalent: (= same)、相等的、等價的
erroneous: 錯誤的、不正確的
especially: 特別地、特別是、尤其
essence: 本質
essential: 基本的、必要的
established: 已建立的
etcetera: 其他、等等
evaluate: 評估
evaluation: 評價、評估
eventually: 最終
evolution: 演化、演變
evolve: 發展、演變
evolving: 演變的
exactly: 正好、確切地、精確地
examine: 審查、(= check)、檢查
example: 範例、例子
excellent: (= good)、優秀的
except: 除外、除了...之外、除了
exclude: 不包含
exclusively: 僅僅、專門地
execute: 執行
executed: 執行、處決、實行
executing: 執行
execution: 執行、實行
exercise: 練習、運用
exercises: 練習、運動
exhibit: 展示
exist: 存在
existence: 存在
expand: 擴展
expansion: 擴展、膨脹
expected: 預期的、預料的
expensive: 昂貴的
experiment: 實驗
experimentation: 實驗
explain: 說明、解釋
explanation: 說明、解釋
explicit: 清楚的、明確的
explicitly: 明確地、清楚地
exploit: 解釋、利用
exploiting: 開發、利用
exponentiation: 冪運算、指數運算
expose: 暴露
express: 表達、表示
expressed: 表達、表示
expresses: 表達
extend: 擴展、延伸
extensive: 廣泛的、延展性
external: 外部的
extra: 附加的、額外的
extract: 抽取、提取
extracted: 提取
facilitate: 促進、配合
facility: 設施
factor: 因素、因子
factory: 工廠
fail: 失敗
familiar: 熟悉的、親切的
family: 系列、家族
far away: 遠離、遙遠的
fashion: 方式、風格
fashionable: 時髦的、時尚的、流行的
feature: 特性
fed: 餵給、餵養(過去式)
feed: 餵養、給、餵食
fewer: 更少的
figure: 圖、數字、形狀、範例、(= example)、圖形、樣貌
figuring: 推斷、計算
finding: 發現
fit on: 適合於
fit: 適合
fix: 固定
flaw: 缺陷
follow: 遵循、跟隨
following: 接著的、以下的
form: 組成、形狀、格式、形式、表格、結構
formal: 規範的、正式的
formalism: 形式化、形式主義
formalization: 形式化、正式的
formally: 形式上、正式地
formed: 形成、構成
formerly: 以前、從前
formulate: 公式化
formulating: 公式化
formulation: 公式化
fortunately: 幸好、幸運地
foundation: 基礎
fragment: 碎片、片段、斷片
freed: 釋放
frequently: 頻繁地
front end: 前端
fundamental: 基本的、根本的
furious: 狂怒的、激烈的
further: 更多的、進一步的
gather: 集結
gathering: 聚集、收集
generality: 一般性
generalize: 推廣、概括
generalizing: 推廣、概括
generated: 產生的、生成的
generating: 生成、產生
generation: 代、生成、產生
gigabytes: GB、千兆字節
gluing: 黏合
go beyond: 超越
goal: 目標、目的
grammar: 語法、文法
grammatical: 語法的
greatest: 最大的
greatly: 大大地
grounded: 基於
grouped: 分組的
grows: 增長、增大
guarantee: 保證、確保
guaranteed: 保證、確保
guide: 指導、引導
had: 有、have p.p.
handle: 處理、應對
handwriting: 硬連線
harnessed: 利用
harnesses: 套、護甲、馬鞍、套索、背心、利用
hash: 井號、#、(= pound sign)、哈希、雜湊
head: 首部、頂部、頭部、頭
held: 握住、舉行
helpful: 有益的、有幫助的
henceforth: 今後、從此以後
heuristic: 啟發式的
hidden: 隱藏的
hides: 隱藏
hierarchical: 階層的、分層的
hierarchies: 階層
hierarchy: 階層
historical: 歷史性的、歷史的
however: 然而
hundreds: 數百
hurt: 傷害
hybrid: 混合的
identifier: 識別符、標識符
identify: 辨認
ill: 不好的、壞的
illustrate: 說明、闡明
illustrated: 闡明的、說明的
illustration: 插圖、舉證
immediate: 立即的、即時的
immediately: 立即
immune: 免除的、免疫的
impact: 影響
impacts: 影響
imparts: 傳授、傳達
imperative: 必要的、命令的
implement: 實作、(= do)、實現、執行
implementation: 實現、執行、實施
implemented: 實現、實施
implementing: 執行、實施
implicit: 暗示的、隱含的
import: 匯入
important: 重要的、重大的
impose: 強加、施加
imposes: 執行、施加
impossible: 不可能的、無法實現的
improve: 改善
in addition to: 除了...之外
in fact: 事實上
in order to: 為了
in place of: 代替、取代
in place: 存在、就位
in principle: 原則上
in the future: 在未來
include: 包含
inconsistencies: 不一致
incorporation: Inc.、企業
increase: 增加
increasing: 增加的、增長的
incrementally: 逐漸地、增量地
incur: 招致
independent: 獨立的
indicate: 指示、指出、表明
indicated: 指示的、表明的
individual: 個體、獨立的、個別的
induce: 導致、引起
inductively: 歸納地
inefficiency: 低效率
infinite: 無限的
infix: 中綴、插入、內嵌
influence: 影響
influenced: 影響
informal: 非正式的、隨意的
informally: 非正式地
informative: 提供資訊的
inherit: 繼承、遺傳
inheritance: 繼承
inherited: 繼承、遺傳
initial: 初始的
initialize: 簽名的、名字開頭的、前面的、最初的
initially: 最初地
innovation: 創新、革新
innovative: 創新的
inorder: 中序
insatiable: 無法滿足的
instance: 例子、實例
instead: 反而
instruction: 指令、命令
insufficient: 不足的
integrated circuit: 集成電路、積體電路
integrated: 整合的
intensive: 密集的
intent: 目的、意圖
intention: 意圖
inter-: 中間、之間
inter: 互相、介於...之間、交叉
interact: 互動
interaction: 互動
interest: 興趣
interesting: 有趣的、引人入勝的
interior: 內部、裡面、內部的
interleaved: 交織的、交錯的
intermediate: 中間的、中級的
internal: 內在的、內部的
international: 國際的
internet: 網際網路
interpret: 翻譯、解釋
interpretation: 解釋、詮釋
interpreted: 直譯的
interpreter: 轉譯者、直譯器
intimately: 密切地
introduce: 介紹、引入
introduced: 引入
introduction: 介紹、引進
intuition: 直覺
intuitive: 易懂的、直觀的
invention: 發明
invocation: 調用
invoke: 調用、引起
involve: 涉及、包含
involves: 涉及
involving: 涉及、包含
issue: 期、問題、執行、(期刊雜誌單位)
italic: 斜體字、斜體
italicize: 斜體字、斜體
ive: 易懂的、直觀的
judge: 判斷
judicious: 神聖的、明智的
justify: 證明、釐清、合理化、辯護
kept: keep p.p.、保持
kilobytes: KB、千字節
labeled: 標籤、標記、標記的、標籤的
large: 大的
largest: 最大的、最多的
latter: 後者、後期
layout: 佈局
leaf: 樹葉、葉子
least: 至少、最少
leave: 離開、遺留、留下
leaves: 留下、樹葉、離開、留下的、葉子
led: 導致
legacy: 初期、遺產
legal: 合法的、法律的
legalize: 合法化、使合法
letter: 信件、字母、字元
leverage: 槓桿
lexeme: 詞根、詞素、詞位
lexical: 詞彙的、詞法的、詞典的
lexically: 詞彙地、詞法地
lie: 躺、謊言
likely: 很可能、可能的
likewise: 同樣地、也
limitation: 限制
line up: 排成一行、排列
linear: 線性的
literally: 逐字地、字面上
locate: 定位、放置
loop: 迴圈、循環
lying: 位於...的
machine: 機器
macro: 巨集、指令、大量
magnitude: 規模、大小、數量
maintain: 維護
maintenance: 維護
major: 大的、主要的
majority: 大多數、主要部分
manageable: 可管理的
managed: 管理的
management: 管理
manipulate: 操作、處理、操縱
manner: 態度、禮節、舉止、風格、方式、方法
massively: 大量地
mathematically: 數學上
matrices: 矩陣
matter: 物質、事情
maximal: 最大的
may: (可能性較大)、可能
mean: 意思是、意味著
meaning: 含義、意義
meaningful: 有意義的
mechanical: 機械的、機械性的
mechanism: 機理、機制
megabytes: 兆字節、MB
merging: 合併、融合
methodology: 方法論
micro-: 微小的
mid: 中
might: (可能性較小)、(may - might - might)、可能
minimize: 最小化
minimizing: 最小化
minus: 減去、減少、負號
misbehave: 行為不當
misnomer: 誤稱
mission: 任務
mistake: 錯誤
mnemonic: 助記的
mobile: 行動的
model: 模式、模擬、模型
modification: 修改、變更
modified: 修改的
module: 模塊、單元
modules: 模組
moreover: 此外
mostly: 大多數
motorola: 摩托羅拉
much: 很多
multicharacter: 多字符的、多字元的
multiple: 多個
multiplication: 乘法、乘法運算
multiply: 乘以
multiprocessor: 多處理器
multithreaded: 多線程的
native: 本地的
natively: 本地地
natural: 自然的
naturally: 自然地、天生地
necessarily: 必需地、必須地、必然地
necessary: 必要的、必需的
needless: 不必要的
neither: 兩者皆不
nest: 嵌套、巢穴
nested: 內含的、內嵌的、嵌套的
nesting: 層疊、嵌套
no longer: 不再
node: 結點、節點
nonboldface: 正常字體、非粗體
nonetheless: 儘管如此
nonitalicized: 正常字體、非斜體
nonterminal: 非終結的、非終端的
nontrivial: 非凡的
norm: 標準
notation: 表示法、標記法、符號系統、記號、符號
notational: 做記號的、標記的、符號的
notations: 記號
note: 筆記、注意
notice: 通知、注意
noting: (note)、記住
notion: 觀念、概念
nuance: 細節、細微差別
numerical: 數字的、數值的
object: 目標
objective: 目標、客觀
obliterate: 消除
obscure: 模糊的
observation: 觀察、觀測
observe: 觀察
obvious: 明顯的
occur: 出現、發生
occurred: 發生
occurrence: 出現、發生
occurrences: 出現、發生
occurring: 發生
offsetting: 抵消
omit: 省略
omitted: 被省略的、被忽略的
on the other hand: 另一方面
once and for all: 一勞永逸
one and for all: 永久地、徹底地
one of the kind: 獨一無二的
only: 僅僅、只有、才
open-ended: 開放式的
operand: 操作數、運算元
operate: 操作、運行
operation: 操作、運行
operator: 運算符、操作符
opportunity: 機會
optimal: 最佳的
optimization: 優化
optimize: 優化
optimizer: 優化器
optional: 可選的、非強制的
order: 順序、次序
ordering: 順序、次序
ordinary: 普通的、常規的
organization: 組織
organize: 組織、安排
oriented: 取向的
originally: 原本地
otherwise: 否則
out of: 由於、源於、沒有、出自於、缺少
outline: (= overview)、概述、(= summary)
overemphasize: 過度強調
overhead: 開銷
overview: 概述
overwise: 過度地、過分地
parallel: 平行的
parallelism: 並行性
parameter: 參量、參數
parameterized: 參數化的
parent: 父母、括號、圓括號
parentheses: 括號、圓括號
parenthesis: 括號、圓括號
parenthesize: 括起來、括號化、括號、括號處理
parenthesized: 括號處理的、括號化的
parenthesizing: 括號化、括號處理
parse: 解析、分析
parser: 解析器、分析器
parsing: 分析、解析、文法解析、構文解析
particular: 特定的、特別的
passes: 傳遞、通過
per: 每個
perform: (= do)、執行、實行、表現
performance: 表現
performed: 執行、實行
perhaps: 也許、可能
permit: 許可、允許
permits: 許可、允許
personal: 個人的
phase: (= stage)、階段、時期、(ph = f)
phenomenon: 現象
philosophy: 哲學
phrase: 短語、片語
physical: 實體的
pictorially: 形象地、圖示地
piece: 部分、塊、片段、片
pieces: 部分、片段
placement: 放置、安置
placing: 放置、安置
plus: 增加、加上
policies: 政策
policy: 規則、政策
polymorphic: 多形的、多態的
popular: 流行的
popularity: 受歡迎
portable: 可攜帶的
portion: 一部分、部分
position: 位置、方位
possibility: 可能、可能性、潛力
possible: 可行的、可能的
possibly: 可能地
postfix: 後綴、後置
postorder: 後序
postscript: 後記
potential: 潛在的
potentially: 潛在地
pound sign: 井號、磅號、(= hash)、#
practically: 實際上
practice: 練習、實踐、實際上
precede: 在...之前、先於
precedence: 優先順序、優先權、優先級、優先
precedes: 在...之前、優先於
predate: 早於、先於
predicate: 謂詞
predominant: 優勢的
prefix: 前綴、前置
preliminary: 初步的、開端的
preorder: 前序
prepackaged: 預先打包的
present: 現在、呈現、展示
presently: 目前、當前
presumably: 大概、可能
prevalence: 流行
prevalent: 流行的
prevents: 防止、阻止
previous: 以前的、先前的
previously: 先前
primarily: 首要地、主要地
primary: 主要的
principal: 主要的
principle: 原理、原則
prior: 先前的
prioritize: 優先考慮
private: 私人的、私有的
probably: 可能
procedure: 流程
process: 處理、過程
processes: 處理、過程
processor: 處理器
produce: 製造、生成、產生
production: 生成、產生
productivity: 效率、生產力
profiler: 分析器
profitably: 獲利地、有利地
progressive: 進步的
progressively: 漸進地、逐步地
prominently: 突出地、顯著地
promising: 有前途的
promote: 促進
prone: 易於...的、傾向於...的
proper: 合適的、適當的、正確的
properties: 屬性
property: 屬性、特性
propose: 提出
proposed: 提出的
protect: 保護、防護
protected: 保護的、受保護的
provide: 提供
provided: 規定、提供
pseudo: 偽、假的
pseudocode: 偽代碼、模擬代碼
pure: 純粹的
purify: 淨化
purpose: (= target)、目的、用途、意圖
purposely: 有目的地、故意地
qualifier: 限定詞、修飾語
qualify: 資格、限定
quantity: 量、數量
queries: 查詢
query: 查詢
quick: 迅速的、快速的
quickly: 快速地
quite: 相當、非常
rampant: 猖獗的
rapid: 快速的
rather than: 而非、而不是
rather: 相當、寧願、寧可
raw: 原始的
reader: 閱讀器、讀者
rearrange: 重新排列
reason: 理由、原因
reasonable: 合理的
received: 接收的、收到的
recently: 近來、最近
recognize: 識別、認識
record: 記錄
recursive: 遞歸的、循環的、反覆的
recursively: 遞迴地、遞歸地
reduce: 減少
redundancies: 冗餘
redundant: 冗餘的
refer: 參考、提及
reference: 參考
referred: 參考、提及
refers: 指
refine: 定義
regarding: 涉及、關於
regin: 範圍、區域
region: 範圍、區域
register: 註冊
regular: 常規的、規則的
relate: 關聯、相關
related: 相關的
relational: 關聯的
relationship: 關係
relative: 相關的、相對的
relatively: 相對地
reliability: 可靠性
relies: 依賴
relocatable: 可重定位的
relocate: 重新定位
remain: 保持
remainder: 餘數、剩餘物
render: 使得、渲染
reorders: 重新排序
repeated: 重複的、反覆的
repeatedly: 反覆地、一再地
report: 報告、報導
represent: 代表、表示、表現
representation: 表示、表徵、呈現方式、表述、表現、(= show)
representative: 代表性的、典型的
representing: 代表、表示、表現
require: 要求
required: 需要的
research: 研究
reserved: 保留的
reside: 居住
resolve: 解釋、(= solve)、解決
resource: 資源
respect: 尊重
respectively: 各自地、相對的、分別地
response: 響應
rest: 休息、剩餘
restrict: 限制、約束
restricting: 限制、約束
retrieve: 恢復
rich: 富有的、豐富的
rigorous: 嚴謹的
robust: 強健的、堅固的
role: 角色
routines: 常規、例行公事
rules: 規定、規則
same: 相同的、一樣的
satisfied: 滿意的
satisfying: 滿足
scale: 規模
scam: 騙局、詐騙
scanner: 掃描器
scanning: 掃描儀、掃描
scheduler: 調度器
scheduling: 調度
scheme: 方案、體系、計劃、格式
schemes: 方案、體系、計劃、格式
science: 科學
scientific: 科學的
scientist: 科學家
secondary: 次要的
section: 部分、章節、(= part)
secure: 留住、安全的
security: 保安、安全
semantic: 語意的、語義的
semantically: 語法上、語義上、字面上
semantics: 語義
sematic: 語義的
semicolon: 分隔符、分號
sense: 意義、感覺
separate: 分開的、獨立的
separated: 分開、分離、分開的、分離的
sequential: 順序的
serve: 服務
several: 數個、幾個、(= some)、若干
shall: 將、應當、應該
shape: 型塑、形狀
shifts: 變化、轉移
short: 短的、簡短的
shorthand: 速記、簡寫
shortly: 立刻、簡短地
shown: (被動)、顯示
sibling: 兄弟姐妹、同胞
siblings: 兄弟姐妹
sign: 符號、標誌
signature: 簽名、特徵
significant: 大的、明顯的、重要的、顯著的
significantly: 顯著地
signifies: 表示、意義
signify: 意味著、表示
similar: 類似的、相似的
similarly: 類似地、相似地
simpler: 更簡單
simplicity: 簡易、簡單性、簡單
simply: 簡單地
simulated: 模擬
simultaneously: 同時地
since: 自從、因為
single: 單個的、單一的
situation: 情境、情況
smallest: 最少的、最小的
so on: 等等
solid: 堅固的
sometimes: 偶爾、有時候
somewhat: 稍微、有點
sophisticate: 複雜的
sophisticated: 複雜的、精密的
speaking: 說
spec: 規格
special: 特殊的、專門的、特別的
specialized: 專業的、專門的
specific: 特定的、具體的
specification: 規範
specified: 指定的、明確的
specifies: 指定
specify: 說明、特定、明確、指定
specifying: 說明、指定
spent: (spend - spent - spent)、花費的
spurred: 促進、刺激
stand for: 代表、象徵
standing: 站立的、常駐的
state-of-the-art: 最先進的
state: 州、陳述、長期狀態
statement: (通常比單一句子長)、陳述、聲明
static: 靜態的、不變的
statically: 靜態地
status: 狀態
still: 仍然
stimulated: 刺激
storage: 存儲
straight: 直
straightforward: 直接的
strict: 嚴格的、嚴謹的
strictly: 嚴格地
structure: 構造、結構
structured: 結構化的
studied: 研究
study: 研究、學習
subscript: 下劃線、下標
subsequent: 後續的、隨後的
subset: 子集合、子集
substantial: 大量的
substituted: 替代的、取代的
subtle: 細微的、微妙的
subtraction: 減法運算、減去、減法、減少
such as: 例如
suffer: 遭受
sufficient: 足夠的
suffix: 後綴、後置
suggestive: 啟發性的、暗示的
summarize: 總結、概括
summary: 總結、概括
superficial: 表面的、膚淺的
supplied: 供應、提供
supplies: 供應
supply: 供應
suppose: 假設、認為
sure: 確定、肯定
surely: 肯定地、無疑地
surround: 環繞、圍繞
synchronization: 同步
synonymously: 同義地、同義詞地
syntactic: 句法的、語法的
syntactically: 句法上的
syntax: 句法、語法
synthesis: 合成、綜合
synthesize: 合成
synthesized: 綜合、合成
systolic array: 脈動陣列
systolic: 脈動的、收縮的
tackle: 處理
tailored: 定制的
taken: 拿、取、採取
taking: 拿、取、採取
talk: 說、(talk - talked - talked)
task: 任務
tearing: 撕裂、撕開
technically: 技術上
technique: 技術
technology: 科技
tedious: 冗長的、乏味的
tell: 告訴、(tell - told - told)
temperature: 溫度
temporary: 暫時的
term: 術語、項、期間
termed: 稱為、叫做
terminal: 終端的、終結的、終端
terminate: 終止、終結
terminology: 術語
that is: 也就是說
therefore: 所以、因此
think of as: 視為
think: 認為、思考
thorough: 徹底的
through: 穿過、通過
throughout: 在整個過程中、貫穿、遍及
thus: 因此
toolkit: 工具包
torn: 撕裂的、破碎的
touches: 觸及
tour: 旅行、巡迴
toward: 朝向、向
towards: 朝向、向
track: 追蹤
tracking: 跟踪
tradeoff: 折衷
tradeoffs: 折衷
transfer: 傳輸
transistor: 晶體管
translate: 轉化、翻譯
transmit: 傳送、傳輸
transmitted: 傳遞的、傳送的
traversal: 遍歷、巡迴
traversals: 遍歷、巡迴
treat: 看待、處理、對待
treated: 被視為、處理、對待
trends: 趨勢
trick: 欺騙、技巧、訣竅
tricked: 欺騙
trivial: 瑣碎的
truly: 真正地、確實地
turn out: 結果是、最終發現
turning: 轉折
type: 打、類型、類別、(打字)
typical: 典型的
typically: 通常、通常地、典型地
typo: 打錯字
unary: 單一的、單元的
undecidable: 無法決定的
underlying: 基礎的、根本的
understand: 理解
understandable: 可理解的、易懂的
understanding: 理解
unexpected: 意外的、出乎意料的、未預料到的
unfortunately: 不幸的是
unintuitive: 不易理解的、不直觀的
unique: 唯一的、獨特的
units: 單位、單元
unlike: 不像
unnecessary: 不必要的
unsound: 無效的、不正確的
unsubscripted: 無下標的
until: 直到、直至
up to this point: 到目前為止
upon: 在...上
usability: 可用性
usual: 通常的
usually: 通常
validate: 驗證
variable: 變量、可變的
variant: 變種、變體
variation: 變化、不同
variety: many kinds
various: 各種的、多樣的、不同的
versus: 對抗、對比、與...相對、對
viable: 能活下去的、可行的
violating: 違反
virtual: 虛擬的
visit: 參觀、訪問
visual: 視覺的
vulnerability: 易受攻擊
vulnerable: 易受攻擊的
whenever: 無論何時
whether: 是否
whole: 整體、全部
widely: 廣泛地、普遍地
wish: 希望
within: 在...之內
worse still: 更糟
worse: 更糟
worth: 值得
written: write p.p.、書面的、寫的
yet have never: 但從沒講過的是
yet: 但是、然而
yield: 放棄、良率、產生
