attach: 附加、連接
rules: 規則、規定
subscript: 下標、下劃線
exploiting: 利用、開發
variant: 變體、變種
pseudocode: 偽代碼、模擬代碼
quantity: 數量、量
example: 例子、範例
node: 節點、結點
scheme: 計劃、方案、體系、格式
attaching: 附加、連接
induce: 引起、導致
formalism: 形式主義、形式化
inductively: 歸納地
constant: 常數、不變的
arity: 元數、元運算元
permits: 許可、允許
repeatedly: 反覆地、一再地
scam: 騙局、詐騙
synthesized: 綜合、合成
associating: 聯想、聯繫
expressed: 表達、表示
computed: 計算、估算
relate: 相關、關聯
sematic: 語義的
appearing: 出現、顯示
annotated: 註解、註釋
annotate: 註解、註釋
traversal: 遍歷、巡迴
inherited: 繼承、遺傳
informally: 非正式地
siblings: 兄弟姐妹
formalization: 形式化、正式的
same: 相同的、一樣的
occurrence: 發生、出現
unsubscripted: 無下標的
distinct: 不同的、獨特的
one of the kind: 獨一無二的
alert: 警報、警告
order: 順序、次序
interleaved: 交錯的、交織的
inter: 交叉、互相、介於...之間
leave: 離開、留下、遺留
termed: 稱為、叫做
schemes: 計劃、方案、體系、格式
discussed: 討論、商量
traversals: 遍歷、巡迴
describing: 描述、形容
execution: 執行、實行
visit: 訪問、參觀
