up to this point: 到目前為止
treat: 對待、看待
single: 單一的
semantically: 語義上、字面上、語法上
equal: 相等的
analysis: 分析
synthesis: 合成
analyze: 分析
synthesize: 合成
break: 拆開
constituent: 成分、組成
imposes: 施加、執行
grammatical: 語法的
representation: 表示、表徵、呈現方式、(= show)
either: 兩者之一
syntactically: 句法上的
ill: 不好的、壞的
unsound: 不正確的、無效的
provide: 提供
informative: 提供資訊的
corrective: 糾正的、正確的
along: 沿著、隨著
desired: 理想的、想要的
front end: 前端
back end: 後端
examine: 檢查、審查、(= check)
detail: 細節
may: 可能、(可能性較大)
might: 可能、(可能性較小)、(may - might - might)
phase: 階段、時期、(ph = f)、(= stage)
decomposition: 分解、分拆
practice: 實際上、實踐
grouped: 分組的
explicitly: 明確地
entire: 整個的
lexical: 詞彙的
syntax: 語法、句法
semantic: 語意的
independent: 獨立的
optimizer: 優化器
dependent: 依賴的
purpose: 目的、(= target)
otherwise: 否則
since: 自從、因為
scanning: 掃描
meaningful: 有意義的
lexeme: 詞素、詞根、詞位
subsequent: 隨後的、後續的
abstract: 抽象的
absolute: 絕對的
component: 組件、元件
entry: 進入
suppose: 認為、假設
assignment: 作業、指派
following: 以下的
multiply: 乘以
stand for: 代表
identify: 辨認
omit: 省略
such as: 例如
notational: 做記號的
convenience: 方便、便利
chosen: 選擇的、(choose - chose - chosen)
initial: 初始的
initialize: 最初的、前面的、簽名的、名字開頭的
blank: 空白
discarded: 丟棄的
multiplication: 乘法
respectively: 相對的
respect: 尊重
technically: 技術上
internal: 內部的
defer: 尊崇、推遲
phrase: 短語、片語
depict: 描述
interior: 內部的
indicate: 指出、指示
consistent: 持續的
usual: 通常的
convention: 習俗、慣例
precedence: 優先權、優先
spec: 規格
efficient: 高效的
automatically: 自動地、(= auto)
certain: 特定的
directed: 指向的、導向的
consistency: 一致性
gather: 集結
both: 兩者皆可
neither: 兩者皆不
important: 重要的
import: 匯入
operand: 操作數
specification: 規範
permit: 允許
conversion: 轉換
convert: 轉換
coercions: 控制、強制
arithmetic: 算術的
applied: 應用的
extra: 額外的
commonly: 常見的、普遍的
think of as: 視為
property: 屬性
consider: 考慮、視為
per: 每個
act: 表現
worth: 值得
noting: 記住、(note)
at most: 最多
thus: 因此
fix: 固定
precedes: 優先於、在...之前
temporary: 暫時的
temperature: 溫度
compute: 計算
above: 以上
fewer: 更少的
principal: 主要的
procedure: 流程
optimization: 優化
attempt: 嘗試、(= try)
objective: 目標、客觀
desire: 可望
consume: 消耗
straightforward: 直接的
straight: 直
follow: 跟隨
reasonable: 合理的
deduce: 推斷
once and for all: 一勞永逸
eliminate: 剔除
moreover: 此外
transmit: 傳送、傳輸
variation: 變化、不同
amount: 數量
significant: 大的、明顯的、重要的
spent: 花費的、(spend - spent - spent)
crucial: 關鍵的
aspect: 方面
judicious: 神聖的、明智的
specifies: 指定
destination: 目的地、終點
pound sign: 磅號、井號、#、(= hash)
hash: 哈希、雜湊、井號、#、(= pound sign)
signifies: 表示、意義
treated: 被視為
previous: 先前的
correct: 正確的
cover: 覆蓋、涵蓋
allocation: 分配、安排
discussion: 討論
organization: 組織
decision: 決定、決策
essential: 必要的、基本的
record: 記錄
various: 各種的、不同的
attribute: 屬性、特徵
allocate: 分配
designed: 設計的
retrieve: 恢復
passes: 通過、傳遞
deal with: 處理、應對
deal: 處理
activities: 活動
particular: 特定的
goal: 目標、目的
consisting: 組成的
careful: 小心的
collection: 收集、集合、版本
similarly: 類似地
profitably: 有利地、獲利地
contain: 包含、容納
profiler: 分析器
harnesses: 套索、利用、套、馬鞍、背心、護甲
so on: 等等
in addition to: 除了...之外
specialized: 專業的、專門的
specifying: 指定
quite: 相當、非常
sophisticated: 複雜的、精密的
integrated: 整合的
remainder: 剩餘物、餘數
regular: 規則的、常規的
scanner: 掃描器
routines: 例行公事、常規
operation: 操作、運行
facilitate: 配合、促進
gathering: 收集、聚集
transmitted: 傳送的、傳遞的
toolkit: 工具包
